NO ./textures/wall_no.png
SO ./textures/wall_so.png
WE ./textures/wall_we.png
EA ./textures/wall_ea.png

F 0,0,0
C 255,255,255

11111
1A001
1N001
10001
11111