NO ./textures/redbrick.png.png
SO ./textures/redbrick.png.png
WE ./textures/redbrick.png.png
EA ./textures/redbrick.png.png

F 220,100,0
C 225,30,0

111111
1N00 1
111111
