NO ./textures/tree2.png
SO ./textures/tree2.png
WE ./textures/tree.png
EA ./textures/tree.png

F 40,60,30
C 10,10,30

11111111111111111111
1N00000000000000000
11101111111110111111
111111 1111111111 11