NO ./textures/tree2.png
SO ./textures/tree2.png
WE ./textures/tree.png
EA ./textures/tree.png

F 40,60,30
C 10,10,30

11111111111111111111
1N000000000000000001
11111111111111111111
