NO ./textures/wall_no.png
SO ./textures/wall_so.png
WE ./textures/wall_ea.png
EA ./textures/wall_we.png

F 220,100,0
C 225,30,0

11111111111111111111
1N00000000000000000
11101111111110111111
111111 1111111111 11