NO ./textures/wall_no.png
SO ./textures/wall_so.png
WE ./textures/wall_ea.png
EA ./textures/wall_we.png

F 193,154,107
C 220,220,220
        1111111111111111111111111
        1111111100110000000000001
        10110000011100000000000011
        10010000000000000N00000001
1111111110110000011100000000000011111111111
100000000011000001110111111111111
11110111111111011100000010001
11110111111111011101010010001
11000000110101011100000010001111111111
10000000000000001100010010001000000001
10000000000000001101010010001111111111
11000001110101011111011110011
11110111 1110101 101111010001
11111111 1111111 111111111111