NO ./textures/redbrick.png
SO ./textures/redbrick.png
WE ./textures/redbrick.png
EA ./textures/redbrick.png

F 220,100,0
C 225,30,0

1111111111111111111111111111111
1000000000000011111000000000001
1000000000000000000000000000001
10N0000000000000000000000000001
1111111111111111111111111111111
