NO ./textures/wall_north.png
SO ./textures/wall_south.png
WE ./textures/wall_west.png
EA ./textures/wall_east.png
F 220,100,0
C 225,30,0

1111111111111111111111111111111
1000000000000000000000000000001
10N0000000000000000000000000001
1000000100100000001111000000001
1000000000000000001000000000001
1000000000000000000000000000001
1111111111111111111111111111111
