1111111111111111111111111111111
1000000000000000000000000000001
1000000000000000000000000000001
1000000000000000000000000000001
1000000000000010000000000000001
1000000000000010000000000000001
1000000000000010000000000000001
1000000000000010000000000000001
1000000000000010000000000000001
1000000000000010000000000000001
100000000000001111100000000001
1000000000000000000000000000001
10N0000000000000000000000000001
1111111111111111111111111111111
