NO ./textures/tree2.png
SO ./textures/tree2.png
WE ./textures/tree.png
EA ./textures/tree.png

F 40,60,30
C 10,10,30

1111111111111111111111111111111
1000000000000000000000000000001
1000000000000000000000000000011
1000000N000000000000000000001
1111111111111111111111111111111
