NO ./textures/tree2.png
SO ./textures/tree2.png
WE ./textures/tree.png
EA ./textures/tree.png

F 40,60,30
C 10,10,30

        1111111111111111111111111
        1111111100110000000000001
        1011000001110000000000001
        1001000000000000N00000001
1111111110110000011100000000000011111111111
100000000011000001110111111111111
11110111111111011100000010001
11110111111111011101010010001
11000000110101011100000010001111111111
10000000000000001100010010001000000001
10000000000000001101010010001111111111
11000001110101011111011110011
11110111 1110101 01111010001
11111111 1111111 111111111111